TÍTULO ORIGINAL	Cave of Forgotten Dreams
AÑO	            2010
DURACIÓN	95 min.
PAÍS	            Francia
DIRECTOR	Werner Herzog
GUIÓN	            Werner Herzog
MÚSICA	Ernst Reijseger
FOTOGRAFÍA	Peter Zeitlinger
REPARTO	Documentary
PRODUCTORA	Arte France / Creative Differences / French Ministry of Culture and Communication / More4 / Werner Herzog Filmproduktion
WEB OFICIAL	http://www.wandavision.com/site/trailer/la_cueva_de_los_suenos_olvidados
PREMIOS	2011: Festival de Berlín: Sección oficial (Fuera de competición/Proyección especial)
2011: Círculo de críticos de Nueva York: Mejor documental
2011: Satellite Awards: Nominada a Mejor largometraje documental
2011: Critics Choice Awards: Nominado a Mejor documental
2011: Premios de la Crítica de Washington (WAFCA): Mejor documental
2011: Asociación de Críticos de Los Angeles: Mejor documental
GÉNERO	Documental | Histórico. 3-D. Prehistoria
SINOPSIS	Documental en 3D presentado en el Festival de Toronto 2010. Fue rodado en la cueva francesa de Chauvet, considerada como uno de los mayores tesoros de la humanidad: es una galería de arte natural con más de 400 pinturas rupestres de 32 mil años de antigüedad. (FILMAFFINITY)
archivo compartido de mi blog